/home/pal/Documents/Framework/GenerativeMutualShapingRL/statistical_analysis/assistance_levels_robot.txt
0,3,0,0,0
3,5,1,2,0
6,1,0,0,0
3,4,0,0,0
3,3,1,1,0
2,2,3,0,0
3,2,1,0,0
5,0,0,0,0
4,1,0,0,0
3,2,0,0,0
5,4,0,0,0
5,1,0,0,0
5,3,0,0,0
5,7,0,1,0
5,7,2,2,0
6,8,2,0,0
3,3,1,2,0
7,6,2,1,0
6,9,3,0,0
5,4,3,1,0
3,3,0,0,0
4,2,2,0,0
10,2,0,0,0
5,1,2,0,0
3,4,1,0,0
4,2,0,0,0
5,1,0,0,0
3,5,1,0,0
5,3,0,0,0
7,1,0,0,0
3,4,0,0,0
3,4,0,0,0
1,5,1,0,0
5,1,0,0,0
3,3,0,0,0
5,3,0,0,0
4,2,0,0,0
5,2,1,0,0
3,4,3,1,0
5,2,3,1,0
4,6,2,3,1
5,7,2,1,1
4,5,4,1,1
6,0,1,1,0
5,2,0,0,1
3,2,0,0,0
2,4,5,0,2
2,5,0,0,0
5,3,1,0,2
2,4,1,0,0
4,5,0,1,0
3,4,3,0,0
2,3,0,0,0
3,2,1,0,0
2,8,3,1,1
3,2,0,0,0
3,2,6,5,3
3,5,0,2,0
6,2,2,3,0
2,5,3,2,1
7,0,6,2,0
4,5,0,0,0
4,3,0,0,0
10,1,0,0,0
8,4,0,0,0
0,7,1,0,0
4,6,0,0,0
5,4,1,5,1
2,3,0,1,0
4,4,2,0,0
8,3,2,0,0
7,1,1,0,0
3,2,0,0,0
1,4,0,0,0
4,2,0,1,0
3,3,1,0,0
3,3,0,0,0
5,3,0,0,0
3,2,0,0,0
4,1,0,0,0
4,3,0,0,0
3,2,2,0,0
7,1,0,0,0
3,2,2,0,0
5,2,0,0,1
5,1,0,0,0
5,0,0,0,0
5,2,0,0,0
5,2,1,1,0
4,1,0,0,0
4,2,0,0,0
2,4,3,0,0
3,4,0,0,0
9,2,1,0,0
4,2,0,0,0
1,7,0,0,0
0,4,6,0,0
4,2,4,0,0
1,4,2,0,0
6,5,1,0,0
1,0,0,0,0
6,2,0,2,0
4,1,0,0,0
4,4,1,0,0
3,6,1,1,0
5,2,0,0,0
1,6,0,0,0
4,3,4,1,0
5,3,1,0,0
2,3,0,0,0
3,2,0,0,0
1,7,2,0,0
4,3,1,0,0
4,1,0,0,0
3,3,1,0,0
1,3,1,0,1
0,5,0,0,0
3,2,0,0,0
4,2,2,1,0
3,3,0,0,0
7,0,1,2,0
3,4,0,1,0
7,0,4,4,0
3,3,8,2,0
4,3,3,3,0
2,5,2,6,1
9,6,3,0,0
10,8,1,0,0
5,3,2,1,0
3,2,4,2,0
3,6,2,1,0
9,1,4,4,0
